00000000000000000000000000000000
00000000000000000000000000000000
00000011111111110111111101111100
00000012111111110121111101211100
00000011111111111111111111111100
00000011111111110111111101111100
00000011111111110111111101111100
00000011111111110111111100010000
00000011111111110111111101111100
00000011111111110111111111211100
00000001000000000111111101111100
00000001000000000000000001111100
00111111111101111110111111111100
00121111111101211110111111111100
00111111111101111111111111111100
00111111111101111110111111111100
00111111111101111110111111111100
00111111111101111110111111111100
00111111111101111110111111111100
00111111111101111110111111111100
00111111111111111110111111111100
00111111111101111110111111111100
00000000000000000000000000000000
00000000000000000000000000000000